0000000000000000000000000000000000000000
000000000000111111111111111100000000000
0000000000001000000000000001000000000000
0000000000001000000010000701000000000000
0000000000001000000000000001000000000000
0000000000001000000000000001000000000000
0000000000001000000010010001000000000000
0000000000001000000000000001000000000000
0000000000001000000000000001000000000000
0000000000001000000000000001000000000000
0000000000001000000000000001000000000000
0000000000001000000000000001000000000000
0000000000001000000000000001000000000000
0000000000001000000000000001000000000000
0000000000001000000000000001000000000000
0000000000001000000000000001000000000000
0000000000001000000000000001000000000000
0000000000001000000000000001000000000000
0000000000001000000000000001000000000000
0000000000001000000000000001000000000000
0000000000001000000000000001000000000000
0000000000001080000000000001000000000000
0000000000001000000000000001000000000000
0000000000001111111111111111000000000000
0000000000000000000000000000000000000000