000000000000000
000000001110000
000000000000000
000000000000000
000000000000000
111100000000000
000000000000000
000000000000000
000000000000000
000000000000000
000000000000000
000000000000000
001110000000000
000000000000000
000000000000000
000000000000000
011100000001111
000000000000000
000000000800000
111111111111111