000000000000
000000001110
000000000000
000000000000
000000000000
111100000000
000000000000
000000000000
000000000000
000000000000
000000000000
000000000000
001110000000
000000000800
000000000000
111111111111