0000000000000000000000000000000000000000
0000000000000000000000000000000000000000
0000000000000000000000000000000000000000
0000000000000000000000000000000000000000
0000000000000000000000000000000000000000
0000000001111111111111111111111000000000
0000000001000000000000000000001000000000
0000000001000000000000000000001000000000
0000000001000000000000000000071000000000
0000000001000000000000000011111000000000
0000000001000000000000000000001000000000
0000000001000000000000000000001000000000
0000000001111000000000000000001000000000
0000000001000000000000000000001000000000
0000000001000000000000000000001000000000
0000000001000000000000000000001000000000
0000000001000000000020000000001000000000
0000000001080000000111100000001000000000
0000000001000000000000000000001000000000
0000000001111111111111111111111000000000
0000000000000000000000000000000000000000
0000000000000000000000000000000000000000
0000000000000000000000000000000000000000
0000000000000000000000000000000000000000
0000000000000000000000000000000000000000