0111000000011110000000000000000000000000
0000000000000000000000000000000000000000
0000000011100000000000000000000000000000
0000000000000000000000000000000000000000
0000000000000000000000000000000000000000
0000000000000000000000000000000000000000
1111000000000000000010000000000000000000
0000000000000000000010000000000000000000
0000000000000000000010000000000000000000
0000000000000000000010000000000000000000
0000000000000000000010000000000000000000
0000000000000000000010000000000000000000
0000000000000000000010000000000000000000
0000000000000000000010000000000000000000
0011100000000000000010000000000000000000
0000000000000000000010000000000000000000
0000000000000000000010000000000000000000
0000000000000000000010000000000000000000
0000000000000000000010000000000000000000
0000000000000000000010000000000000000000
0000000000000000000010000000000000000000
0111000000011110000010000000000000000000
0000000000000000000010000000000000000000
0000000008000000000010000000000000000000
1111111111111111111111111111111111111111