0000000000000000000000000000000000000000
0000000000000000000000000000000000000000
0000000000000000000000000000000000000000
0000000000000000000000000000000000000000
0000000000000000000000000000000000000000
0000000000111111111111111111111000000000
0000000000100000000000000000001000000000
0000000000100000000000000000001000000000
0000000000100000000000000000071000000000
0000000000100000000000000011111000000000
0000000000100000000000000000001000000000
0000000000100000000000000000001000000000
0000000000111100000000000000001000000000
0000000000100000000000000000001000000000
0000000000100000000000000000001000000000
0000000000100000000000000000001000000000
0000000000100000000002000000001000000000
0000000000108000000011110000001000000000
0000000000100000000000000000001000000000
0000000000111111111111111111111000000000
0000000000000000000000000000000000000000
0000000000000000000000000000000000000000
0000000000000000000000000000000000000000
0000000000000000000000000000000000000000
0000000000000000000000000000000000000000