0000000000000000000000000000000000000000
0000000011111111111111110000000000000000
0000000010000000000000010000000000000000
0000000010700000000000010000000000000000
0000000010000000000000010000000000000000
0000000010000000000000010000000000000000
0000000011111111111100010000000000000000
0000000000000000100000010000000000000000
0000000000000000100000010000000000000000
0000000000000000100000010000000000000000
0000000000000000100000010000000000000000
0000000000000000100000010000000000000000
0000000000000000100000010000000000000000
0000000000000000100000010000000000000000
0000000000000000100000010000000000000000
0000000000000000101000010000000000000000
0000000000000000100000010000000000000000
0000000000000000100000010000000000000000
0000000000000000100000010000000000000000
0000000000000000100000010000000000000000
0000000000000000108000010000000000000000
0000000000000000100000010000000000000000
0000000000000000111111110000000000000000
0000000000000000000000000000000000000000
0000000000000000000000000000000000000000