0000000000000000000000000000000000000000
0000000000000000000000000000000000000000
0000000000000000000000000000000000000000
0000000000000000000000000000000000000000
0000000000000000000000000000000000000000
0000000001111111111111111111111000000000
0000000001000000000000000000001000000000
0000000001070000000000000000001000000000
0000000001000000000000000000001000000000
0000000001000000000000000000001000000000
0000000001000000000000000000001000000000
0000000001000000000000111000001000000000
0000000001000000000000000000001000000000
0000000001000000000000000000001000000000
0000000001000000000000000000001000000000
0000000001000000000000000000001000000000
0000000001000000000000000000001000000000
0000000001080000000000000000001000000000
0000000001000000000000000000001000000000
0000000001111111111111111111111000000000
0000000000000000000000000000000000000000
0000000000000000000000000000000000000000
0000000000000000000000000000000000000000
0000000000000000000000000000000000000000
0000000000000000000000000000000000000000