0000000000000000000000000000000000000000
0000000000000000000000000000000000000000
0000000000000000000000000000000000000000
0000000001111111111111111111111000000000
0000000001000000001000000000001000000000
0000000001000000001000000000071000000000
0000000001000000001000000001111000000000
0000000001000000001000000000001000000000
0000000001000000001000000000001000000000
0000000001000001001000000000001000000000
0000000001000001001000000000001000000000
0000000001000001001000000000001000000000
0000000001000111001000000000001000000000
0000000001000001001000000000001000000000
0000000001000001001000000000001000000000
0000000001000001001000000000001000000000
0000000001000001001000000000001000000000
0000000001000001001000000000001000000000
0000000001080001001000000000001000000000
0000000001000001020000000000001000000000
0000000001111111111111111111111000000000
0000000000000000000000000000000000000000
0000000000000000000000000000000000000000
0000000000000000000000000000000000000000